8 8
00000000
00000000
00000000
01100000
00000000
00011110
00000000
01100000
